Uptown Funk! - Mark Ronson Featuring Bruno Mars
Party Rock Anthem - LMFAO Featuring Lauren Bennett & GoonRock
Shape Of You - Ed Sheeran
Closer - The Chainsmokers Featuring Halsey
Girls Like You - Maroon 5 Featuring Cardi B
We Found Love - Rihanna Featuring Calvin Harris
Old Town Road - Lil Nas X Featuring Billy Ray Cyrus
Somebody That I Used To Know - Gotye Featuring Kimbra
Despacito - Luis Fonsi & Daddy Yankee Featuring Justin Bieber
Rolling In The Deep - Adele
Sunflower (Spider-Man: Into The Spider-Verse) - Post Malone & Swae Lee
Without Me - Halsey
Call Me Maybe - Carly Rae Jepsen
Blurred Lines - Robin Thicke Featuring T.I. + Pharrell
Perfect - Ed Sheeran
Sicko Mode - Travis Scott
All About That Bass - Meghan Trainor
Royals - Lorde
God's Plan - Drake
Moves Like Jagger - Maroon 5 Featuring Christina Aguilera
Happy - Pharrell Williams
Just The Way You Are - Bruno Mars
Rockstar - Post Malone Featuring 21 Savage
TiK ToK - Ke$ha
See You Again - Wiz Khalifa Featuring Charlie Puth
Dark Horse - Katy Perry Featuring Juicy J
Thrift Shop - Macklemore & Ryan Lewis Featuring Wanz
One More Night - Maroon 5
We Are Young - fun. Featuring Janelle Monae
That's What I Like - Bruno Mars
The Hills - The Weeknd
All Of Me - John Legend
Happier - Marshmello & Bastille
Shake It Off - Taylor Swift
One Dance - Drake Featuring WizKid & Kyla
Radioactive - Imagine Dragons
Sexy And I Know It - LMFAO
Someone Like You - Adele
Counting Stars - OneRepublic
E.T. - Katy Perry Featuring Kanye West
Trap Queen - Fetty Wap
Love Yourself - Justin Bieber
Firework - Katy Perry
Give Me Everything - Pitbull Featuring Ne-Yo, Afrojack & Nayer
Locked Out Of Heaven - Bruno Mars
Love The Way You Lie - Eminem Featuring Rihanna
Thinking Out Loud - Ed Sheeran
Sorry - Justin Bieber
California Gurls - Katy Perry Featuring Snoop Dogg
Dynamite - Taio Cruz
Lucid Dreams - Juice WRLD
Hello - Adele
Work - Rihanna Featuring Drake
Grenade - Bruno Mars
Hey, Soul Sister - Train
I Like It - Cardi B, Bad Bunny & J Balvin
Wake Me Up! - Avicii
Don't Let Me Down - The Chainsmokers Featuring Daya
Havana - Camila Cabello Featuring Young Thug
OMG - Usher Featuring will.i.am
Bad Guy - Billie Eilish
Fancy - Iggy Azalea Featuring Charli XCX
Can't Feel My Face - The Weeknd
Wow. - Post Malone
Blank Space - Taylor Swift
Cheap Thrills - Sia Featuring Sean Paul
Some Nights - fun.
Need You Now - Lady Antebellum
7 Rings - Ariana Grande
Stay With Me - Sam Smith
Can't Hold Us - Macklemore & Ryan Lewis Featuring Ray Dalton
Better Now - Post Malone
Roar - Katy Perry
Rude - MAGIC!
Thank U, Next - Ariana Grande
Sugar - Maroon 5
Payphone - Maroon 5 Featuring Wiz Khalifa
Airplanes - B.o.B Featuring Hayley Williams
Psycho - Post Malone Featuring Ty Dolla $ign
Bodak Yellow (Money Moves) - Cardi B
Watch Me - Silento
Can't Stop The Feeling! - Justin Timberlake
Cheerleader - OMI
Bad Romance - Lady Gaga
Stronger (What Doesn't Kill You) - Kelly Clarkson
What Do You Mean? - Justin Bieber
Nice For What - Drake
Sucker - Jonas Brothers
Meant To Be - Bebe Rexha & Florida Georgia Line
Timber - Pitbull Featuring Ke$ha
Take Me To Church - Hozier
Hotline Bling - Drake
Heathens - twenty one pilots
Super Bass - Nicki Minaj
F**k You! (Forget You) - CeeLo Green
Panda - Desiigner
Break Your Heart - Taio Cruz Featuring Ludacris
In My Feelings - Drake
Wrecking Ball - Miley Cyrus
Ho Hey - The Lumineers
